111111111111111
1C1C0000C0000C1
111000C0000P001
10100E000000111
1010000C0000001
1100C0000C000C1
100000000000001
111111111111111