111111111111111
1E0C0000C0000C1
100011C0
        000P001
100001111110001
1CCCCCCCCCCCCC1
1000C0000C000C1
100000000000001
111111111111111