1111111111111111
1P0000E1100010C1
1001100100100101
1001000101C01C01
1101C01000100101
1101110010010101
100000000C110001
1111111111111111